# this file defines acronyms, one acronym per line
ACL - Access Control List
AES - Advanced Encryption Standard
AN - Association Number
AN - Auto Negotiation
API - Application Program Interface
ARP - Address Resolution Protocol
ASIC - Application Specific Integrated Circuit
BFD - Bidirectional Forwarding Detection
BFDV6 - Bidirectional Forwarding Detection for IPv6
BGP - Border Gateway Protocol
CAM - Content Addressable Memory
CB - Callback
CBS - Committed Burst Size
CCITT - Comite Consultatif International de Telegraphique et Telephonique
CFI - Canonical Format Indicator
CIDR - Classless Inter Domain Routing
CIR - Committed Information Rate
CPU - Central Processing Unit
CRC - Cyclic Redundancy Code
DHCP - Dynamic Host Configuration Protocol
DLD - Dead Lock Detection
DLDR - Dead Lock Detection and Recovery
DLL - Dynamic Link Library
DLR - Dead Lock Recovery
DNAT - Destination Network Address Translation
DSCP - Differentiated Services Code Point
DTEL - Data Plane Telemetry
ECMP - Equal Cost Multi-Path
ECN - Explicit Congestion Notification
ECT - ECN Capable Transport
EEE - Electrical and Electronics Engineering
ERSPAN - Encapsulated Remote SPAN
FCS - Frame Check Sequence
FD - File Descriptor
FDB - Forwarding Data Base
FEC - Forward Error Correction
FPGA - Field Programmable Gate Array
GCM - Galois Counter Mode
GPB - Google Protocol Buffers
GRE - Generic Routing Encapsulation
GRPC - GRPC Remote Procedure Call
HW - Hardware
I2C - Inter Integrated Circuit
ICMP - Internet Control Message Protocol
ICMPV6 - Internet Control Message Procotol for IPv6
IEEE - Institute of Electrical and Electronics Engineers
IFA - Inband Flow Analyzer
IFA1 - Inband Flow Analyzer version 1
IFA2 - Inband Flow Analyzer version 2
IGMP - Internet Group Management Protocol
IHL - Internet Header Length
IOAM - In-situ Operations And Management
IP - Internet Protocol
IPG - Inter-Packet Gap
IPFIX - IP Flow Information Export
IP2ME - IP packets to local router IP
IPMC - Intelligent Platform Management Controller
L2 - Layer 2
L2MC - Layer 2 Multi Cast
L3 - Layer 3
LAG - Link Aggregation Group
LPM - Longest Prefix Match
MAC - Medium Access Control
MMU - Memory Management Unit
MPLS - Multi Protocol Label Switching
MTU - Maximum Transmission Unit
NHLFE - Next Hop Label Forwarding Entry
NPU - Numeric Processing Unit
NRZ - Non Return to Zero
OAM - Operations Administration and Maintenance
OUI - Organizationally Unique Identifier
PAM4 - Pulse Amplitude Modulation 4-level
PBS - Peak Burst Size
PCI - Peripheral Component Interconnect
PFC - Priority Flow Control
PIR - Peak Information Rate
PN - Packet Number
PTP - Precision time protocol
QOS - Quality of Service
RARP - Reverse Address Resolution Protocol
RFC - Request For Comment
RPF - Reverse Path Forwarding
RSPAN - Remote Span
SA - Secure Association
SAK - Secure Association Key
SAI - Switch Abstraction Interface
SCI - Secure Channel Identifier
SC - Secure Channel
SDK - Software Development Kit
SFLOW - Sampled Flow
SG - (S,G) Source-specific multicast
SNAT - Source Network Address Translation
SNMP - Simple Network Management Protocol
SNR - Signal to Noise Ratio
SPAN - Switched Port Analyzer
SQE - Signal Quality Errors
SSCI - Short Secure Channel Identifier
SSH - Secure Shell
SSL - Secure Socket Layer
STP - Spanning Tree Protocol
TC - Traffic Control
TCAM - Ternary Content Addressable Memory
TCP - Transmission Control Protocol
TLS - Transport Layer Security
TOS - Type Of Service
TPID - Tag Protocol Identifier
TTL - Time to Leave
UDF - User-Defined Field
UDP - User Datagram Protocol
VNI - Virtual Network Interface
VNID - Virtual Network Identifier
VR - Virtual Router
VRF - Virtual Route Forwarding
VRRP - Virtual Router Redundancy Protocol
VXLAN - Virtual Extensible LAN
WCMP - Weighted Cost Multipath
WRED - Weighted Random Early Detection
WWW - World Wide Web
XG - (*,G) Any-source Multicast
XPN - Extended Packet Number
XOFF - Transmitter Off
XON - Transmitter On
FW  - Firmware
MDIO - Management Data Input/Output
I2C - I squared C
CPLD - Complex programmable logic device
EEPROM - Electrically erasable programmable read-only memory
PRBS - Pseudorandom binary sequence
